NO ./settings/image/north.xpm
SO ./settings/image/south.xpm
WE ./settings/image/west.xpm
EA ./settings/image/east.xpm

F 220,100,0
C 225,30,0

1111111
1000001
1000001
1000001
1002001
1111111