C 127,204,227
SO ./settings/image/south.xpm
WE ./settings/image/west.xpm
F 0,81,51
EA ./settings/image/east.xpm
NO ./settings/image/north.xpm


111111111111111111111111
100000000000000000000001
100000000000000000000001
100000000000000000000001
100000111110000101010001
100000100010000000000001
1000001000|0000100010001
100000100010000000000001
10000011011000011-110001
100000000000000000000001
100000000000001000000001
10000000000000|000W00001
100000000000001000000001
100000000000001000000001
100000000000000000000001
100000000000000000000001
111111111000000000000001
110100001000000000000001
110000101000000000000001
110100001000000000000001
110111111000000000000001
110000000000000000000001
111111111000000000000001
111111111111111111111111