NO ./settings/image/north.xpm
SO ./settings/image/south.xpm
WE ./settings/image/west.xpm
EA ./settings/image/east.xpm

F 0,81,51
C 127,204,227

111111111111111111111111
100000000000000000000001
100000000000000000000001
100000000000000000000001
100000111110000101010001
100000100010000000000001
100000100000000100010001
100000100010000000000001
100000110110000110110001
100000000000000000000001
100000000000001000000001
100000000000000000W00001
100000000000001000000001
100000000000001000000001
100000000000000000000001
100000000000000000000001
111111111000000000000001
110100001000000000000001
110000101000000000000001
110100001000000000000001
110111111000000000000001
110000000000000000000001
111111111000000000000001
111111111111111111111111