NO ./map/test.xpm
SO ./map/test.xpm
WE ./map/test.xpm
EA ./map/test.xpm

F 220,100,0
C 225,30,0

11111
1E002
10001
20001
10001
11111
