NO ./image/north.xpm
SO ./image/south.xpm
WE ./image/west.xpm
EA ./image/east.xpm

S ./image/sprite.xpm

F 220,100,0
C 225,30,0

11111
1E001
10001
10001
10001
11111
