NO ./image/north.xpm
SO ./image/south.xpm
WE ./image/west.xpm
EA ./image/east.xpm

S ./image/sprite0.xpm
S ./image/sprite1.xpm
S ./image/sprite2.xpm
S ./image/sprite3.xpm

F 0,81,51
C 127,204,227

111111111111111111111111
100000000000000000000001
100000000000000000000001
100000000000000000000001
100000111110000101010001
100000100010000000000001
100000100010000100010001
100000100010000000000001
100000110110000302010001
100000000000000000000001
100000000000003000000001
100000000000002000W00001
100000000000001000000001
100000000000000000000001
100000000000000000000001
100000000000000001030001
111111111000000000000001
110100001000000000000001
110000101000000000000001
110100001000000000000001
110111111000000000000001
110000000000000000000001
111111111000000000000001
111111111111111111111111
